"","ID","Days","ItemNo","Memorablity","Accuracy","Messages","RecallBeforeHint","Vividness","GuessedMonth","NumItems","Month","Sentiment","TimeJudgmentDistance","DatingError"
"1",103,17,1,11,1,19,1,10,1,30,1,12,0,0
"2",103,14,2,7.4285717,1,6,3,10,1,30,1,1,0,0
"3",103,68,3,30.714287,1,11,1,9,3,30,3,1,0,0
"4",103,279,4,21,0,3,5,5,9,30,10,1,1,1
"5",103,52,5,30,1,4,1,10,2,30,2,1,0,0
"6",103,203,6,0.57142854,0,2,4,9,7,30,7,3,0,0
"7",103,264,7,21,1,5,1,8,9,30,9,1,0,0
"8",103,41,8,31,1,3,4,10,2,30,2,3,0,0
"9",103,288,9,-3,0,6,4,7,11,30,10,1,1,-1
"10",103,224,10,48,1,5,1,9,4,30,8,2,4,4
"11",103,85,11,1,1,12,1,10,12,30,3,92,9,-9
"12",103,38,12,65.85714,1,2,1,10,1,30,2,5,1,1
"13",103,250,13,21,1,2,1,9,9,30,9,18,0,0
"14",103,118,14,41,1,10,1,6,6,30,4,12,2,-2
"15",103,77,15,25,1,2,1,10,2,30,3,3,1,1
"16",103,19,16,21,1,6,1,10,1,30,1,1,0,0
"17",103,324,17,1.2857141,0,3,4,8,11,30,11,16,0,0
"18",103,279,18,21,1,4,4,8,9,30,10,1,1,1
"19",103,135,19,31,1,2,5,6,4,30,5,26,1,1
"20",103,139,20,31,1,3,3,10,10,30,5,1,5,-5
"21",103,160,21,61,0,3,3,8,3,30,6,16,3,3
"22",103,139,22,54.857143,1,2,5,7,7,30,5,2,2,-2
"23",103,354,23,-11.714287,1,3,5,2,-1,30,12,1,13,13
"24",103,202,24,31,1,11,3,7,9,30,7,2,2,-2
"25",103,253,25,49.857143,1,3,1,9,9,30,9,2,0,0
"26",103,222,26,41.285713,0,2,3,3,7,30,8,17,1,1
"27",103,308,27,61,1,2,5,8,10,30,11,1,1,1
"28",103,321,28,28.714285,1,15,1,10,10,30,11,12,1,1
"29",103,160,29,26.142857,0,13,4,7,5,30,6,16,1,1
"30",103,220,30,31,1,5,3,5,11,30,8,1,3,-3
"31",104,40,1,17,1,8,1,10,2,17,2,3,0,0
"32",104,123,2,5.714285,1,6,1,9,6,17,5,14,1,-1
"33",104,38,3,31,1,3,1,10,1,17,2,36,1,1
"34",104,101,4,26.428572,1,3,1,9,4,17,4,1,0,0
"35",104,191,5,26.142857,1,3,1,10,9,17,7,5,2,-2
"36",104,1,6,11,1,11,1,10,0,17,1,18,1,1
"37",104,257,7,31,1,2,4,9,6,17,9,1,3,3
"38",104,25,8,21,1,35,1,10,2,17,1,12,1,-1
"39",104,118,9,11,1,8,4,5,4,17,4,1,0,0
"40",104,141,10,16,1,12,5,7,5,17,5,1,0,0
"41",104,288,11,21,1,7,3,8,10,17,10,14,0,0
"42",104,238,12,1,1,2,5,6,5,17,8,1,3,3
"43",104,206,13,21,1,7,2,10,9,17,7,1,2,-2
"44",104,85,14,21,1,5,2,8,3,17,3,60,0,0
"45",104,214,15,31,0,2,4,9,9,17,8,3,1,-1
"46",104,315,16,61,1,10,5,5,12,17,11,3,1,-1
"47",104,52,17,31,0,11,5,1,7,17,2,3,5,-5
"48",105,2,1,1.5714283,0,12,3,7,2,11,1,3,1,-1
"49",105,273,2,25.714287,1,7,1,9,9,11,10,14,1,1
"50",105,213,3,3.4285717,1,5,2,6,7,11,8,3,1,1
"51",105,17,4,16,1,4,1,9,1,11,1,1,0,0
"52",105,221,5,1,1,2,4,5,5,11,8,1,3,3
"53",105,48,6,31,1,3,1,8,2,11,2,1,0,0
"54",105,55,7,41,1,5,3,7,2,11,2,1,0,0
"55",105,13,8,5.5714283,1,4,3,9,1,11,1,1,0,0
"56",105,327,9,31,1,3,4,7,11,11,11,12,0,0
"57",105,48,10,-10.25,1,9,5,4,5,11,2,1,3,-3
"58",105,142,11,12.25,0,3,2,1,-1,11,5,3,6,6
"59",108,73,1,11,1,20,1,7,3,21,3,1,0,0
"60",108,55,2,21,1,7,1,9,2,21,2,1,0,0
"61",108,26,3,16,1,3,1,10,2,21,1,12,1,-1
"62",108,31,4,46.857143,1,4,1,10,2,21,1,3,1,-1
"63",108,39,5,41,1,5,1,8,1,21,2,12,1,1
"64",108,206,6,11,1,2,3,7,-1,21,7,1,8,8
"65",108,105,7,31,1,6,1,8,4,21,4,1,0,0
"66",108,67,8,11,0,2,4,7,2,21,3,1,1,1
"67",108,166,9,26.571428,1,6,4,5,7,21,6,12,1,-1
"68",108,15,10,21,1,95,1,10,0,21,1,60,1,1
"69",108,213,11,22.857143,0,2,4,5,7,21,8,1,1,1
"70",108,240,12,21.142857,1,2,1,8,9,21,9,23,0,0
"71",108,327,13,18.5,0,4,1,4,-1,21,11,3,12,12
"72",108,315,14,1,1,13,2,1,-1,21,11,1,12,12
"73",108,83,15,21.857143,1,9,1,10,3,21,3,3,0,0
"74",108,321,16,31,1,7,1,10,11,21,11,3,0,0
"75",108,345,17,41,0,5,3,8,11,21,12,1,1,1
"76",108,291,18,21,1,4,1,3,9,21,10,1,1,1
"77",108,342,19,27,1,2,4,6,4,21,12,1,8,8
"78",108,213,20,31,1,5,1,5,-1,21,8,5,9,9
"79",108,212,21,23.571428,0,3,4,5,7,21,8,1,1,1
"80",108,261,22,27.285713,1,7,2,8,7,21,9,1,2,2
"81",110,195,1,24,0,5,5,1,-1,11,7,1,8,8
"82",110,229,2,21,0,3,5,3,-1,11,8,1,9,9
"83",110,196,3,11,0,6,1,10,2,11,7,12,5,5
"84",110,115,4,14.571428,0,6,4,10,4,11,4,29,0,0
"85",110,266,5,11,0,6,5,1,9,11,9,1,0,0
"86",110,40,6,31,1,5,1,10,1,11,2,1,1,1
"87",110,172,7,21,0,2,5,1,-1,11,6,1,7,7
"88",110,14,8,11,1,70,1,10,1,11,1,1,0,0
"89",110,114,9,11,0,5,4,10,4,11,4,1,0,0
"90",110,27,10,48.42857,1,335,5,5,2,11,1,1,1,-1
"91",110,14,11,69.85715,1,74,5,5,2,11,1,12,1,-1
"92",110,236,12,41,1,3,3,10,9,11,8,1,1,-1
"93",110,170,13,26,0,6,3,5,4,11,6,1,2,2
"94",110,82,14,11,1,5,5,5,5,11,3,1,2,-2
"95",113,66,1,34.142857,1,6,1,10,2,23,3,40,1,1
"96",113,195,2,7.1428566,1,2,1,10,6,23,7,3,1,1
"97",113,99,3,51,1,2,1,10,3,23,4,3,1,1
"98",113,214,4,-5.25,1,5,5,7,4,23,8,1,4,4
"99",113,147,5,11,1,5,4,9,5,23,5,1,0,0
"100",113,114,6,47.857143,1,15,1,9,4,23,4,23,0,0
"101",113,118,7,21,1,4,1,10,4,23,4,1,0,0
"102",113,53,8,11,1,36,1,10,2,23,2,1,0,0
"103",113,251,9,51,1,24,1,10,8,23,9,2,1,1
"104",113,120,10,31,1,2,5,5,5,23,5,38,0,0
"105",113,56,11,3.1428576,1,7,1,10,2,23,2,3,0,0
"106",113,7,12,29.714285,1,22,1,10,0,23,1,23,1,1
"107",113,46,13,41,1,2,1,9,2,23,2,1,0,0
"108",113,250,14,21,0,2,5,4,6,23,9,16,3,3
"109",113,26,15,-1.4285715,1,5,4,10,1,23,1,18,0,0
"110",113,69,16,-4.285714,1,3,1,10,2,23,3,1,1,1
"111",113,27,17,23,1,10,1,10,1,23,1,3,0,0
"112",113,140,18,21,1,3,5,8,5,23,5,1,0,0
"113",113,264,19,61,1,2,5,7,9,23,9,1,0,0
"114",113,172,20,31,1,10,3,10,5,23,6,1,1,1
"115",113,165,21,46.142857,1,2,5,1,-1,23,6,12,7,7
"116",113,305,22,35,1,2,4,7,10,23,11,1,1,1
"117",113,186,23,2.5714283,1,5,5,1,7,23,7,27,0,0
"118",114,257,1,-7.75,0,2,5,1,-1,23,9,1,10,10
"119",114,353,2,1,0,3,4,2,12,23,12,1,0,0
"120",114,320,3,1,0,2,5,1,-1,23,11,3,12,12
"121",114,8,4,53.142857,1,32,1,10,1,23,1,23,0,0
"122",114,257,5,31,1,2,1,10,4,23,9,3,5,5
"123",114,75,6,31,1,3,1,9,3,23,3,14,0,0
"124",114,160,7,10.428572,0,12,5,1,6,23,6,1,0,0
"125",114,75,8,31,0,10,5,2,-1,23,3,14,4,4
"126",114,221,9,44,1,7,1,10,5,23,8,14,3,3
"127",114,206,10,21,1,10,1,9,6,23,7,1,1,1
"128",114,4,11,17,1,3,1,10,0,23,1,1,1,1
"129",114,49,12,50.714287,1,4,1,9,1,23,2,1,1,1
"130",114,11,13,51,1,6,1,10,1,23,1,1,0,0
"131",114,127,14,21,1,3,1,10,4,23,5,1,1,1
"132",114,68,15,36,1,9,1,10,3,23,3,5,0,0
"133",114,43,16,25.714287,1,2,2,7,2,23,2,25,0,0
"134",114,105,17,31,1,2,1,8,3,23,4,1,1,1
"135",114,220,18,61,1,6,1,10,7,23,8,26,1,1
"136",114,155,19,48.42857,0,4,5,1,4,23,6,2,2,2
"137",114,326,20,12.714286,0,2,4,2,11,23,11,3,0,0
"138",114,218,21,71,0,7,3,1,8,23,8,1,0,0
"139",114,149,22,21,1,4,1,9,5,23,5,1,0,0
"140",114,33,23,30.428572,1,12,1,8,2,23,2,1,0,0
"141",115,312,1,11,0,4,5,2,-1,17,11,3,12,12
"142",115,97,2,21,1,7,4,9,3,17,4,3,1,1
"143",115,84,3,21,0,5,5,1,-1,17,3,12,4,4
"144",115,214,4,11,0,6,4,2,7,17,8,3,1,1
"145",115,253,5,56.42857,1,3,1,10,9,17,9,3,0,0
"146",115,119,6,30.571428,1,3,4,5,4,17,4,23,0,0
"147",115,162,7,11,0,7,4,3,6,17,6,12,0,0
"148",115,5,8,1,1,3,2,10,0,17,1,1,1,1
"149",115,311,9,76.57143,0,2,5,1,12,17,11,5,1,-1
"150",115,10,10,31,0,6,1,10,1,17,1,1,0,0
"151",115,78,11,1,1,5,4,9,5,17,3,12,2,-2
"152",115,25,12,11,1,7,3,10,2,17,1,1,1,-1
"153",115,77,13,18,1,2,5,9,3,17,3,12,0,0
"154",115,264,14,41,1,9,2,5,9,17,9,3,0,0
"155",115,174,15,31,0,9,5,1,-1,17,6,1,7,7
"156",115,296,16,11,1,8,1,10,5,17,10,3,5,5
"157",115,207,17,21,1,24,4,5,1,17,7,1,6,6
"158",116,133,1,21,0,2,2,9,5,21,5,1,0,0
"159",116,151,2,31,0,2,4,7,3,21,6,1,3,3
"160",116,42,3,45.428574,1,7,1,10,2,21,2,3,0,0
"161",116,174,4,1,0,2,4,9,8,21,6,12,2,-2
"162",116,67,5,8.428572,0,3,2,9,3,21,3,1,0,0
"163",116,17,6,8.571426,1,14,1,10,1,21,1,3,0,0
"164",116,44,7,11,1,18,1,10,2,21,2,1,0,0
"165",116,110,8,21.285715,0,2,4,5,4,21,4,12,0,0
"166",116,187,9,33.428574,1,7,1,9,6,21,7,1,1,1
"167",116,268,10,38.42857,0,4,5,1,9,21,9,25,0,0
"168",116,286,11,21,1,2,5,2,9,21,10,1,1,1
"169",116,299,12,1,1,33,2,8,10,21,10,1,0,0
"170",116,347,13,-0.57142866,0,2,2,1,10,21,12,1,2,2
"171",116,60,14,19.285715,0,2,4,1,2,21,3,3,1,1
"172",116,108,15,41,1,8,2,8,6,21,4,1,2,-2
"173",116,24,16,61,1,10,1,10,1,21,1,41,0,0
"174",116,319,17,25.285713,1,2,1,7,12,21,11,5,1,-1
"175",116,326,18,11,1,6,5,10,9,21,11,23,2,2
"176",116,195,19,-8.142858,1,5,2,8,7,21,7,1,0,0
"177",116,45,20,38.57143,1,5,4,9,2,21,2,14,0,0
"178",116,25,21,11,1,9,1,7,1,21,1,1,0,0
"179",117,28,1,41,1,110,1,10,1,20,1,1,0,0
"180",117,138,2,41,0,2,5,1,-1,20,5,3,6,6
"181",117,69,3,53.428574,1,4,5,10,6,20,3,16,3,-3
"182",117,337,4,17.142857,1,2,3,9,10,20,12,1,2,2
"183",117,329,5,41.285713,1,2,4,9,-1,20,11,1,12,12
"184",117,157,6,50.857143,1,6,1,10,5,20,6,1,1,1
"185",117,263,7,48.857143,1,15,1,10,-1,20,9,1,10,10
"186",117,126,8,21,1,9,1,10,-1,20,5,1,6,6
"187",117,329,9,41,1,10,1,10,0,20,11,12,11,11
"188",117,79,10,37,1,3,1,10,3,20,3,12,0,0
"189",117,131,11,27.285715,1,2,3,10,6,20,5,14,1,-1
"190",117,318,12,27.142857,0,12,3,10,11,20,11,5,0,0
"191",117,252,13,40,1,2,1,10,8,20,9,29,1,1
"192",117,57,14,31,1,6,5,9,-1,20,2,1,3,3
"193",117,207,15,69,0,2,3,1,7,20,7,12,0,0
"194",117,223,16,79.42857,1,6,3,7,8,20,8,3,0,0
"195",117,154,17,11,1,6,3,10,7,20,6,16,1,-1
"196",117,11,18,41,1,3,3,10,1,20,1,3,0,0
"197",117,48,19,31,1,6,1,10,2,20,2,14,0,0
"198",117,282,20,40.42857,0,4,4,8,-1,20,10,1,11,11
"199",117,48,21,32.428574,0,8,3,1,3,20,2,12,1,-1
"200",118,258,1,21,1,2,1,6,9,19,9,1,0,0
"201",118,21,2,11,1,111,1,10,1,19,1,1,0,0
"202",118,234,3,13.857142,1,2,1,8,8,19,8,1,0,0
"203",118,55,4,11,1,8,1,9,3,19,2,1,1,-1
"204",118,41,5,21,1,15,1,7,2,19,2,18,0,0
"205",118,80,6,41,1,6,1,8,3,19,3,3,0,0
"206",118,90,7,31,1,26,1,5,2,19,3,1,1,1
"207",118,150,8,37,1,3,1,6,6,19,6,1,0,0
"208",118,99,9,45.571426,1,2,1,5,4,19,4,12,0,0
"209",118,326,10,37.25,1,2,2,3,9,19,11,1,2,2
"210",118,234,11,38.857143,1,2,2,4,7,19,8,25,1,1
"211",118,237,12,63.428574,1,4,2,6,7,19,8,25,1,1
"212",118,74,13,14.75,1,11,1,8,2,19,3,12,1,1
"213",118,345,14,50.571426,0,2,5,2,12,19,12,3,0,0
"214",118,87,15,48.42857,1,6,2,5,4,19,3,14,1,-1
"215",118,134,16,21,1,5,2,5,4,19,5,1,1,1
"216",118,101,17,20.285715,0,2,2,1,8,19,4,14,4,-4
"217",118,145,18,1,0,4,5,1,-1,19,5,3,6,6
"218",118,204,19,41,1,6,5,3,8,19,7,12,1,-1
"219",118,336,20,49.714287,0,2,5,2,10,19,12,16,2,2
"220",121,159,1,30.571428,1,5,1,10,4,29,6,12,2,2
"221",121,83,2,61,1,33,1,10,4,29,3,1,1,-1
"222",121,6,3,1,1,62,1,10,1,29,1,1,0,0
"223",121,222,4,51,1,4,1,10,8,29,8,25,0,0
"224",121,104,5,31,0,2,4,10,4,29,4,3,0,0
"225",121,52,6,1,1,10,1,10,4,29,2,12,2,-2
"226",121,262,7,31,1,4,1,10,6,29,9,1,3,3
"227",121,13,8,36,1,17,1,10,1,29,1,14,0,0
"228",121,276,9,4,1,2,4,5,8,29,10,1,2,2
"229",121,126,10,20.285715,1,38,1,10,4,29,5,1,1,1
"230",121,265,11,5.8571424,1,8,3,10,8,29,9,1,1,1
"231",121,52,12,5.285714,1,3,3,10,1,29,2,1,1,1
"232",121,274,13,30.857143,0,7,3,7,6,29,10,1,4,4
"233",121,159,14,11.571428,1,10,3,10,4,29,6,3,2,2
"234",121,100,15,16.714287,1,12,1,10,4,29,4,5,0,0
"235",121,293,16,11,0,4,4,1,-1,29,10,1,11,11
"236",121,137,17,19.285715,0,14,4,2,12,29,5,1,7,-7
"237",121,85,18,16.714287,1,11,3,10,3,29,3,3,0,0
"238",121,201,19,28.571428,1,4,2,10,7,29,7,1,0,0
"239",121,58,20,1,1,11,1,9,3,29,2,1,1,-1
"240",121,173,21,19.57143,1,2,1,10,6,29,6,25,0,0
"241",121,212,22,30,1,8,1,10,5,29,8,1,3,3
"242",121,16,23,11,0,39,3,7,1,29,1,1,0,0
"243",121,337,24,29.428572,1,3,1,5,7,29,12,34,5,5
"244",121,98,25,11,1,5,4,2,4,29,4,1,0,0
"245",121,182,26,11,1,3,3,10,5,29,7,12,2,2
"246",121,82,27,11,0,5,2,1,-1,29,3,3,4,4
"247",121,304,28,0.28571427,1,6,3,10,10,29,11,12,1,1
"248",121,135,29,27.857143,1,25,3,3,4,29,5,12,1,1
"249",121,348,30,11,1,3,2,5,12,29,12,1,0,0
"250",122,28,1,1,1,201,1,8,2,15,1,1,1,-1
"251",122,82,2,31,1,10,1,8,3,15,3,1,0,0
"252",122,153,3,21,0,2,5,5,5,15,6,1,1,1
"253",122,228,4,33.142857,0,2,4,4,7,15,8,5,1,1
"254",122,99,5,32,1,7,1,8,4,15,4,1,0,0
"255",122,103,6,0.5714283,1,6,1,10,4,15,4,1,0,0
"256",122,156,7,11.428572,0,6,5,7,5,15,6,1,1,1
"257",122,295,8,21,1,4,1,8,9,15,10,1,1,1
"258",122,12,9,11,1,3,1,10,0,15,1,3,1,1
"259",122,122,10,31,1,3,2,7,5,15,5,1,0,0
"260",122,97,11,42.142857,1,10,1,10,3,15,4,1,1,1
"261",122,133,12,11,1,6,2,7,4,15,5,1,1,1
"262",122,156,13,21,0,2,5,1,-1,15,6,1,7,7
"263",122,66,14,11,1,3,5,7,5,15,3,3,2,-2
"264",122,275,15,21,0,3,5,1,8,15,10,1,2,2
"265",122,148,16,55.714287,1,5,2,5,5,15,5,1,0,0
"266",124,154,1,0.4285714,0,20,5,1,-1,22,6,1,7,7
"267",124,0,2,31,1,38,1,10,0,22,1,1,1,1
"268",124,263,3,11,0,3,5,1,-1,22,9,3,10,10
"269",124,97,4,11,0,10,5,1,-1,22,4,3,5,5
"270",124,348,5,11,0,4,5,1,11,22,12,3,1,1
"271",124,116,6,11,1,46,5,4,4,22,4,1,0,0
"272",124,325,7,31.142857,0,4,4,3,11,22,11,3,0,0
"273",124,85,8,21,0,14,5,2,-1,22,3,1,4,4
"274",124,327,9,31,0,2,5,3,12,22,11,14,1,-1
"275",124,5,10,21,1,13,1,10,0,22,1,1,1,1
"276",124,280,11,21,1,2,1,5,-1,22,10,1,11,11
"277",124,278,12,17.857143,0,3,5,1,-1,22,10,1,11,11
"278",124,121,13,20.571428,1,12,5,3,-1,22,5,12,6,6
"279",124,81,14,43.142857,1,32,1,9,4,22,3,1,1,-1
"280",124,337,15,18.571428,0,4,5,3,12,22,12,3,0,0
"281",124,99,16,27.285713,1,60,5,7,4,22,4,1,0,0
"282",124,216,17,11,0,15,5,1,-1,22,8,1,9,9
"283",124,18,18,41,1,30,1,10,1,22,1,1,0,0
"284",124,42,19,1,1,7,5,7,2,22,2,12,0,0
"285",124,145,20,21,1,11,5,7,5,22,5,1,0,0
"286",124,56,21,39.857143,1,44,1,10,2,22,2,3,0,0
"287",124,252,22,26,1,19,5,3,10,22,9,3,1,-1
"288",124,85,23,28.571428,1,2,5,4,4,22,3,12,1,-1
"289",125,22,1,19.75,1,3,1,10,1,18,1,1,0,0
"290",125,23,2,11,1,11,1,10,1,18,1,1,0,0
"291",125,294,3,11,1,6,1,10,11,18,10,1,1,-1
"292",125,166,4,11,1,5,3,10,3,18,6,1,3,3
"293",125,76,5,1,1,4,3,10,2,18,3,1,1,1
"294",125,41,6,11,1,3,1,10,1,18,2,1,1,1
"295",125,7,7,-10.25,1,8,2,10,1,18,1,1,0,0
"296",125,165,8,21,1,3,2,8,3,18,6,1,3,3
"297",125,116,9,-5.249998,1,6,3,8,6,18,4,1,2,-2
"298",125,334,10,1,1,6,1,10,11,18,12,3,1,1
"299",125,64,11,31,1,6,1,10,2,18,3,1,1,1
"300",125,145,12,1,0,3,3,5,5,18,5,3,0,0
"301",125,84,13,11,1,21,3,10,4,18,3,1,1,-1
"302",125,343,14,3.4999995,1,5,1,10,11,18,12,1,1,1
"303",125,319,15,1,1,4,2,5,11,18,11,25,0,0
"304",125,211,16,11,1,3,2,6,7,18,8,1,1,1
"305",125,190,17,30.714285,1,3,2,9,8,18,7,1,1,-1
"306",125,320,18,1,1,2,2,10,11,18,11,5,0,0
"307",126,114,1,71,1,7,1,10,4,19,4,4,0,0
"308",126,115,2,31.285713,1,3,1,10,4,19,4,3,0,0
"309",126,54,3,17.571428,0,3,4,10,4,19,2,1,2,-2
"310",126,322,4,27.857143,1,2,1,10,11,19,11,27,0,0
"311",126,8,5,31,1,7,1,10,0,19,1,1,1,1
"312",126,356,6,7.4285717,1,3,1,7,5,19,12,1,7,7
"313",126,184,7,-8,1,2,1,10,3,19,7,5,4,4
"314",126,41,8,21,1,2,1,10,1,19,2,3,1,1
"315",126,294,9,31.714285,1,5,1,10,10,19,10,29,0,0
"316",126,217,10,-16.5,1,3,5,10,4,19,8,1,4,4
"317",126,21,11,41,1,4,1,10,0,19,1,1,1,1
"318",126,233,12,4.7142854,1,2,1,10,8,19,8,23,0,0
"319",126,140,13,-14,0,2,1,1,-1,19,5,12,6,6
"320",126,79,14,-16.285713,1,5,4,10,2,19,3,3,1,1
"321",126,236,15,8.5,1,3,5,8,2,19,8,1,6,6
"322",126,260,16,39.285713,0,3,5,1,6,19,9,12,3,3
"323",126,72,17,20.428572,1,2,1,10,1,19,3,1,2,2
"324",126,58,18,5.999999,1,4,1,10,1,19,2,1,1,1
"325",126,97,19,44.142857,0,3,4,10,3,19,4,3,1,1
"326",127,29,1,5.142857,0,3,4,5,-1,13,1,1,2,2
"327",127,69,2,21,0,18,5,1,-1,13,3,1,4,4
"328",127,206,3,21,0,2,4,5,7,13,7,1,0,0
"329",127,321,4,51,0,2,5,1,-1,13,11,12,12,12
"330",127,75,5,31,1,3,5,6,2,13,3,1,1,1
"331",127,51,6,30,1,9,1,10,2,13,2,1,0,0
"332",127,30,7,11,0,3,3,10,1,13,2,1,1,1
"333",127,164,8,41,1,2,3,10,2,13,6,12,4,4
"334",127,1,9,31,1,13,1,10,0,13,1,3,1,1
"335",127,14,10,35.714287,1,8,2,1,1,13,1,1,0,0
"336",127,1,11,21,0,12,1,10,0,13,1,12,1,1
"337",127,248,12,21,0,5,2,5,-1,13,9,12,10,10
"338",127,206,13,31,0,5,1,3,0,13,7,1,7,7
"339",129,3,1,-0.25,1,14,1,10,0,17,1,1,1,1
"340",129,231,2,13.5,1,20,1,10,9,17,8,1,1,-1
"341",129,261,3,11,1,5,1,10,9,17,9,1,0,0
"342",129,44,4,31,1,7,4,9,2,17,2,1,0,0
"343",129,340,5,11,1,17,5,10,12,17,12,1,0,0
"344",129,254,6,26.142857,1,5,3,4,12,17,9,1,3,-3
"345",129,0,7,11,1,14,4,7,0,17,1,1,1,1
"346",129,87,8,9.857142,1,25,1,10,3,17,3,1,0,0
"347",129,98,9,14.428572,0,16,4,2,4,17,4,3,0,0
"348",129,75,10,48.57143,1,18,4,7,3,17,3,1,0,0
"349",129,323,11,7.1428566,1,8,3,8,12,17,11,23,1,-1
"350",129,7,12,21,1,13,5,8,0,17,1,1,1,1
"351",129,253,13,-1.5,1,14,5,10,10,17,9,1,1,-1
"352",129,330,14,21,1,24,5,3,12,17,12,1,0,0
"353",129,73,15,8.428572,1,10,3,4,3,17,3,16,0,0
"354",129,343,16,1,1,33,4,7,12,17,12,1,0,0
"355",129,106,17,21,0,6,4,1,3,17,4,1,1,1
"356",131,219,1,20.714285,1,2,1,6,7,16,8,1,1,1
"357",131,117,2,19.428572,1,4,1,5,4,16,4,1,0,0
"358",131,203,3,11,1,3,1,5,8,16,7,1,1,-1
"359",131,242,4,5.5714283,1,2,1,5,8,16,9,1,1,1
"360",131,53,5,31,1,25,1,8,1,16,2,1,1,1
"361",131,167,6,41,1,2,1,6,7,16,6,1,1,-1
"362",131,52,7,20.285715,0,5,4,5,1,16,2,1,1,1
"363",131,58,8,21,1,13,1,9,1,16,2,1,1,1
"364",131,28,9,11.428572,1,23,1,10,1,16,1,5,0,0
"365",131,7,10,1,1,15,1,9,0,16,1,3,1,1
"366",131,328,11,13,1,9,1,5,11,16,11,16,0,0
"367",131,9,12,21,1,57,3,10,0,16,1,3,1,1
"368",131,99,13,0.85714287,1,2,5,5,3,16,4,1,1,1
"369",131,339,14,21,1,9,4,5,11,16,12,1,1,1
"370",131,338,15,27.571428,1,4,1,5,5,16,12,40,7,7
"371",131,219,16,31,0,2,5,1,-1,16,8,1,9,9
"372",131,117,17,31,1,8,2,6,3,16,4,1,1,1
"373",132,237,1,1,0,2,5,2,-1,11,8,1,9,9
"374",132,12,2,21,1,11,1,10,0,11,1,40,1,1
"375",132,231,3,31,1,6,1,10,8,11,7,1,1,-1
"376",132,43,4,32.571426,0,5,5,3,2,11,2,16,0,0
"377",132,143,5,3.5,0,6,4,1,4,11,5,1,1,1
"378",132,290,6,21,0,9,1,10,10,11,10,1,0,0
"379",132,17,7,15,1,5,1,10,0,11,1,5,1,1
"380",132,249,8,11,0,3,1,9,9,11,9,1,0,0
"381",132,1,9,31,1,3,1,10,0,11,1,1,1,1
"382",132,319,10,51,0,2,3,1,-1,11,11,18,12,12
"383",132,285,11,19.142857,1,2,2,8,10,11,10,1,0,0
"384",134,294,1,3.5,1,2,1,10,6,16,10,12,4,4
"385",134,253,2,1,0,3,1,1,-1,16,9,1,10,10
"386",134,1,3,4.285714,1,11,1,10,0,16,1,1,1,1
"387",134,115,4,4,0,2,1,1,-1,16,4,12,5,5
"388",134,255,5,11,1,4,1,10,9,16,9,1,0,0
"389",134,164,6,21,0,3,4,4,5,16,6,1,1,1
"390",134,206,7,-6.5,1,2,4,7,7,16,7,1,0,0
"391",134,126,8,-18,1,8,1,10,4,16,5,1,1,1
"392",134,298,9,-1.5,1,5,2,10,9,16,10,1,1,1
"393",134,265,10,1,1,3,2,10,10,16,9,1,1,-1
"394",134,111,11,11,1,6,2,10,6,16,4,3,2,-2
"395",134,284,12,11,1,5,4,8,11,16,10,1,1,-1
"396",134,134,13,31,0,2,4,2,5,16,5,25,0,0
"397",134,61,14,6.4285717,1,2,2,10,3,16,3,3,0,0
"398",134,100,15,11,1,4,1,6,-1,16,4,1,5,5
"399",134,147,16,14.75,0,11,2,6,2,16,5,12,3,3
"400",136,12,1,1,1,6,1,10,1,14,1,12,0,0
"401",136,37,2,71,1,2,1,10,1,14,2,4,1,1
"402",136,14,3,21,1,8,1,10,1,14,1,1,0,0
"403",136,78,4,31,1,5,1,10,2,14,3,36,1,1
"404",136,31,5,29.857143,0,26,1,10,0,14,2,60,2,2
"405",136,204,6,27.25,1,2,1,10,5,14,7,15,2,2
"406",136,233,7,31,0,2,1,1,-1,14,8,3,9,9
"407",136,57,8,28,0,2,3,1,4,14,2,14,2,-2
"408",136,318,9,71,0,6,1,5,12,14,11,59,1,-1
"409",136,339,10,11,0,7,1,5,2,14,12,1,10,10
"410",136,338,11,30.571428,0,2,4,5,12,14,12,12,0,0
"411",136,106,12,48.714287,1,4,1,7,4,14,4,14,0,0
"412",136,226,13,38.57143,0,3,2,5,7,14,8,12,1,1
"413",136,160,14,41,0,3,4,7,6,14,6,1,0,0
"414",138,10,1,41,1,4,1,10,0,23,1,3,1,1
"415",138,121,2,21,1,13,1,10,4,23,5,1,1,1
"416",138,220,3,3.4999995,1,6,1,10,9,23,8,1,1,-1
"417",138,141,4,1,1,36,1,10,6,23,5,25,1,-1
"418",138,108,5,40.42857,1,3,1,10,3,23,4,1,1,1
"419",138,168,6,31,1,3,1,10,6,23,6,1,0,0
"420",138,208,7,-12.75,1,3,1,10,11,23,7,1,4,-4
"421",138,63,8,41,1,2,1,10,1,23,3,1,2,2
"422",138,264,9,19.75,1,4,1,10,9,23,9,1,0,0
"423",138,313,10,33.857143,1,2,1,10,9,23,11,1,2,2
"424",138,10,11,31,1,2,1,10,0,23,1,5,1,1
"425",138,315,12,11,1,7,1,7,10,23,11,1,1,1
"426",138,334,13,1,1,2,1,9,12,23,12,1,0,0
"427",138,122,14,41,1,16,1,10,3,23,5,14,2,2
"428",138,159,15,38.42857,1,2,2,10,5,23,6,1,1,1
"429",138,270,16,42.571426,1,2,1,8,12,23,10,3,2,-2
"430",138,210,17,41,1,10,2,10,6,23,7,1,1,1
"431",138,170,18,11,1,2,1,10,6,23,6,1,0,0
"432",138,243,19,21,1,3,1,9,8,23,9,3,1,1
"433",138,317,20,25.285713,1,4,1,10,12,23,11,1,1,-1
"434",138,58,21,37.857143,1,3,2,10,1,23,2,3,1,1
"435",138,100,22,14.75,0,6,1,5,4,23,3,3,1,-1
"436",138,271,23,11,0,16,4,3,-1,23,10,3,11,11
"437",140,7,1,39.75,1,222,1,10,0,13,1,12,1,1
"438",140,9,2,56.285713,1,113,1,9,0,13,1,3,1,1
"439",140,41,3,21,1,9,4,4,2,13,2,1,0,0
"440",140,86,4,30.571428,1,13,1,6,1,13,3,16,2,2
"441",140,3,5,48.57143,1,120,1,8,0,13,1,1,1,1
"442",140,247,6,31,1,3,5,5,7,13,9,12,2,2
"443",140,117,7,18.142857,1,3,2,7,4,13,4,1,0,0
"444",140,234,8,31,0,5,4,7,7,13,8,1,1,1
"445",140,200,9,44.285713,1,2,5,4,7,13,7,3,0,0
"446",140,46,10,24.285713,1,4,2,6,2,13,2,1,0,0
"447",140,85,11,1,1,13,4,5,1,13,3,16,2,2
"448",140,41,12,51,1,5,3,5,4,13,2,1,2,-2
"449",140,160,13,51,1,21,5,1,6,13,6,1,0,0
"450",140,65,14,26.857143,0,3,5,6,2,13,3,1,1,1
"451",140,167,15,44.42857,0,4,5,1,5,13,6,1,1,1
"452",140,152,16,21,1,27,5,2,6,13,6,1,0,0
"453",141,151,1,20.285715,1,6,1,10,5,22,6,12,1,1
"454",141,108,2,44.142857,1,24,1,10,4,22,4,1,0,0
"455",141,68,3,23.571428,1,4,1,10,3,22,3,3,0,0
"456",141,46,4,15.714286,1,7,1,7,1,22,2,1,1,1
"457",141,2,5,31,1,25,1,10,0,22,1,1,1,1
"458",141,141,6,41,1,2,1,10,5,22,5,1,0,0
"459",141,245,7,11,1,19,1,8,4,22,9,3,5,5
"460",141,276,8,21,1,21,1,10,9,22,10,1,1,1
"461",141,85,9,21,1,3,1,6,3,22,3,5,0,0
"462",141,46,10,17.428572,1,8,1,6,2,22,2,1,0,0
"463",141,347,11,41,1,9,1,10,11,22,12,1,1,1
"464",141,159,12,9.857143,1,5,5,1,-1,22,6,1,7,7
"465",141,144,13,25.428572,1,7,1,6,5,22,5,14,0,0
"466",141,275,14,41,1,2,2,6,9,22,10,3,1,1
"467",141,100,15,15,1,2,2,8,3,22,4,3,1,1
"468",141,133,16,32.857143,1,7,2,10,4,22,5,1,1,1
"469",141,275,17,31,0,2,4,3,6,22,10,12,4,4
"470",141,12,18,1,1,15,2,2,2,22,1,1,1,-1
"471",141,193,19,47.857143,0,3,3,10,7,22,7,5,0,0
"472",141,93,20,21,0,3,2,5,3,22,4,1,1,1
"473",141,248,21,61,1,20,2,5,-1,22,9,14,10,10
"474",141,21,22,-6.5,1,15,5,1,-1,22,1,1,2,2
"475",142,7,1,39.714287,1,13,1,10,0,24,1,14,1,1
"476",142,219,2,11,1,2,1,10,7,24,8,1,1,1
"477",142,19,3,11,1,3,1,10,1,24,1,12,0,0
"478",142,46,4,1,1,2,1,10,2,24,2,3,0,0
"479",142,174,5,21,1,3,5,1,-1,24,6,12,7,7
"480",142,55,6,41,1,17,1,10,2,24,2,1,0,0
"481",142,114,7,21,1,16,1,10,3,24,4,47,1,1
"482",142,195,8,41,1,9,5,10,6,24,7,7,1,1
"483",142,87,9,5.285715,1,3,3,10,3,24,3,1,0,0
"484",142,284,10,-5.5714283,0,2,5,5,7,24,10,1,3,3
"485",142,147,11,41,1,12,1,10,5,24,5,3,0,0
"486",142,251,12,22.714287,1,5,1,10,8,24,9,23,1,1
"487",142,200,13,51,1,3,1,8,9,24,7,29,2,-2
"488",142,236,14,26.142857,1,2,1,10,7,24,8,14,1,1
"489",142,137,15,24.285713,1,3,1,10,5,24,5,12,0,0
"490",142,327,16,61,1,2,5,10,8,24,11,24,3,3
"491",142,156,17,54.57143,0,2,5,1,5,24,6,1,1,1
"492",142,318,18,22.857143,1,2,5,10,9,24,11,1,2,2
"493",142,303,19,31,1,5,5,10,11,24,11,3,0,0
"494",142,290,20,61,0,6,5,1,-1,24,10,16,11,11
"495",142,74,21,11,0,2,5,10,2,24,3,25,1,1
"496",142,158,22,32.714287,1,18,3,5,5,24,6,1,1,1
"497",142,296,23,7.25,1,2,5,5,11,24,10,1,1,-1
"498",142,222,24,21,1,12,5,10,11,24,8,3,3,-3
"499",143,94,1,41,1,2,1,10,4,15,4,1,0,0
"500",143,23,2,29.75,1,13,1,9,2,15,1,5,1,-1
"501",143,74,3,9.571428,1,2,1,10,3,15,3,3,0,0
"502",143,159,4,1,1,13,1,8,5,15,6,1,1,1
"503",143,102,5,1,1,13,1,10,3,15,4,12,1,1
"504",143,102,6,21,1,22,1,7,4,15,4,23,0,0
"505",143,133,7,-7.75,0,2,4,8,4,15,5,1,1,1
"506",143,121,8,25.42857,1,3,1,9,4,15,5,1,1,1
"507",143,152,9,21,1,5,1,10,5,15,6,12,1,1
"508",143,5,10,44.714287,1,4,1,10,0,15,1,3,1,1
"509",143,27,11,56.142857,1,6,5,3,-1,15,1,16,2,2
"510",143,165,12,30.428572,1,2,4,9,7,15,6,14,1,-1
"511",143,82,13,1,1,15,5,9,3,15,3,27,0,0
"512",143,297,14,9.285713,0,3,2,9,3,15,10,27,7,7
"513",143,185,15,41,0,6,4,1,4,15,7,1,3,3
"514",144,19,1,9.571428,1,7,3,10,1,23,1,12,0,0
"515",144,50,2,31,1,3,3,10,1,23,2,1,1,1
"516",144,27,3,-2.2857141,1,4,3,10,1,23,1,1,0,0
"517",144,114,4,21,1,12,1,10,4,23,4,1,0,0
"518",144,136,5,41,1,12,3,10,4,23,5,47,1,1
"519",144,69,6,21,1,15,3,10,0,23,3,1,3,3
"520",144,72,7,31.142857,1,6,3,10,2,23,3,1,1,1
"521",144,313,8,21,1,21,3,10,10,23,11,1,1,1
"522",144,254,9,14.285714,1,3,5,5,-1,23,9,1,10,10
"523",144,94,10,21,1,3,4,10,2,23,4,1,2,2
"524",144,20,11,11,1,4,4,10,1,23,1,3,0,0
"525",144,37,12,11,0,4,4,1,-1,23,2,1,3,3
"526",144,57,13,31,1,2,4,10,3,23,2,1,1,-1
"527",144,207,14,-10.285714,1,6,3,10,6,23,7,1,1,1
"528",144,82,15,14,0,3,4,5,3,23,3,1,0,0
"529",144,239,16,11,1,2,4,5,6,23,8,16,2,2
"530",144,329,17,21,1,48,1,9,10,23,11,1,1,1
"531",144,285,18,10.142858,1,3,4,5,7,23,10,1,3,3
"532",144,156,19,18.142857,1,8,1,10,5,23,6,1,1,1
"533",144,314,20,11,0,11,4,1,-1,23,11,1,12,12
"534",144,343,21,1,0,17,4,1,-1,23,12,5,13,13
"535",144,345,22,20.571428,1,19,5,5,11,23,12,1,1,1
"536",144,119,23,13,1,16,4,2,-1,23,4,62,5,5
"537",147,103,1,31,0,17,4,2,-1,30,4,12,5,5
"538",147,101,2,1,1,6,1,10,2,30,4,3,2,2
"539",147,99,3,11,1,2,3,7,3,30,4,1,1,1
"540",147,51,4,51,1,7,1,10,1,30,2,1,1,1
"541",147,199,5,35.428574,0,3,5,4,10,30,7,1,3,-3
"542",147,351,6,-8.571428,0,9,5,6,12,30,12,1,0,0
"543",147,88,7,-12.857143,1,3,2,8,3,30,3,3,0,0
"544",147,19,8,10.714287,1,31,1,10,0,30,1,1,1,1
"545",147,235,9,38.857143,0,11,4,8,9,30,8,1,1,-1
"546",147,166,10,11,1,4,2,8,4,30,6,1,2,2
"547",147,166,11,17.428572,0,4,5,1,-1,30,6,1,7,7
"548",147,17,12,101,1,231,1,10,0,30,1,1,1,1
"549",147,189,13,11,0,7,4,9,8,30,7,1,1,-1
"550",147,89,14,21,1,4,2,7,3,30,3,3,0,0
"551",147,246,15,38.142857,1,7,3,9,7,30,9,14,2,2
"552",147,134,16,11,1,8,4,6,4,30,5,3,1,1
"553",147,74,17,42.571426,0,5,4,1,4,30,3,16,1,-1
"554",147,271,18,-4.4285717,1,7,5,2,10,30,10,1,0,0
"555",147,255,19,23,1,11,4,8,7,30,8,14,1,1
"556",147,280,20,61,1,8,4,4,9,30,10,13,1,1
"557",147,140,21,18.714285,0,2,3,6,5,30,5,1,0,0
"558",147,319,22,21,1,2,1,6,9,30,11,1,2,2
"559",147,311,23,21,1,3,3,4,10,30,11,25,1,1
"560",147,224,24,12.428572,1,5,4,7,7,30,8,3,1,1
"561",147,26,25,1,1,21,5,2,1,30,1,1,0,0
"562",147,34,26,11,1,10,5,8,2,30,2,1,0,0
"563",147,57,27,84.28571,1,4,5,9,1,30,2,1,1,1
"564",147,264,28,29.75,1,2,4,3,9,30,9,1,0,0
"565",147,199,29,6.142857,1,3,3,6,7,30,7,3,0,0
"566",147,357,30,1,1,3,5,8,12,30,12,3,0,0
"567",147,327,31,39.285713,1,6,5,5,11,30,11,3,0,0
"568",151,89,1,-3,1,10,1,10,6,12,3,1,3,-3
"569",151,1,2,29.428572,1,30,1,10,0,12,1,23,1,1
"570",151,15,3,20.428572,1,8,1,10,1,12,1,1,0,0
"571",151,41,4,-6.1428576,1,42,1,10,1,12,2,1,1,1
"572",151,84,5,11,1,5,1,10,4,12,3,1,1,-1
"573",151,73,6,21,0,12,1,9,-1,12,3,25,4,4
"574",151,356,7,21,1,2,2,5,9,12,12,12,3,3
"575",151,50,8,21,1,19,1,9,3,12,2,36,1,-1
"576",151,140,9,21,0,2,2,5,5,12,5,25,0,0
"577",151,259,10,28.857143,1,3,2,9,6,12,9,5,3,3
"578",151,148,11,1,1,3,2,7,5,12,5,1,0,0
"579",151,9,12,100.14285,1,9,1,10,0,12,1,25,1,1
"580",152,16,1,21,1,2,1,10,0,17,1,1,1,1
"581",152,32,2,11.857143,1,14,1,10,1,17,2,1,1,1
"582",152,75,3,31,1,6,1,10,3,17,3,1,0,0
"583",152,9,4,81.71429,1,20,1,10,0,17,1,3,1,1
"584",152,4,5,41,0,2,1,10,0,17,1,12,1,1
"585",152,296,6,20.142857,1,10,1,10,10,17,10,1,0,0
"586",152,40,7,71.85714,1,2,1,10,1,17,2,12,1,1
"587",152,78,8,31,1,2,3,10,5,17,3,1,2,-2
"588",152,69,9,31,1,15,1,10,2,17,3,1,1,1
"589",152,160,10,21,1,3,4,10,2,17,6,3,4,4
"590",152,169,11,48.42857,1,2,3,10,5,17,6,27,1,1
"591",152,49,12,16.428572,1,8,4,10,2,17,2,12,0,0
"592",152,264,13,41,1,2,3,10,9,17,9,1,0,0
"593",152,141,14,14.428572,1,5,3,10,4,17,5,5,1,1
"594",152,143,15,71,1,11,3,10,5,17,5,1,0,0
"595",152,271,16,1,0,2,3,2,9,17,10,1,1,1
"596",152,176,17,56.285713,1,2,1,10,6,17,6,5,0,0
"597",153,45,1,4,1,3,1,10,2,6,2,25,0,0
"598",153,144,2,1,1,7,5,10,5,6,5,14,0,0
"599",153,7,3,11,1,11,1,10,0,6,1,14,1,1
"600",153,146,4,21,1,5,4,10,5,6,5,23,0,0
"601",153,15,5,31,1,97,1,5,1,6,1,1,0,0
"602",153,35,6,11,1,3,1,10,2,6,2,16,0,0
"603",153,149,7,44.857143,0,15,4,1,5,6,5,12,0,0
"604",154,2,1,36.142857,1,24,1,10,0,19,1,1,1,1
"605",154,109,2,35.857143,1,46,1,10,3,19,4,12,1,1
"606",154,57,3,41,1,4,1,10,2,19,2,12,0,0
"607",154,12,4,43.571426,1,111,1,10,0,19,1,3,1,1
"608",154,1,5,41.285713,1,100,1,10,0,19,1,14,1,1
"609",154,80,6,31,1,79,1,10,2,19,3,1,1,1
"610",154,88,7,21,1,4,1,10,3,19,3,1,0,0
"611",154,206,8,41,1,3,1,10,-1,19,7,3,8,8
"612",154,160,9,51,1,7,1,10,-1,19,6,73,7,7
"613",154,87,10,-7.75,1,3,1,10,-1,19,3,1,4,4
"614",154,39,11,12.25,1,6,1,10,1,19,2,34,1,1
"615",154,36,12,1,1,9,1,10,2,19,2,14,0,0
"616",154,134,13,41,1,10,3,10,5,19,5,25,0,0
"617",154,198,14,19.75,1,5,4,10,5,19,7,12,2,2
"618",154,167,15,21,1,2,3,10,3,19,6,12,3,3
"619",154,122,16,11,1,48,3,10,-1,19,5,3,6,6
"620",154,271,17,17.142857,1,2,3,10,8,19,10,3,2,2
"621",154,91,18,11,1,5,1,10,8,19,4,1,4,-4
"622",154,239,19,31,1,29,4,6,7,19,8,1,1,1
"623",154,331,20,19.571428,0,26,3,1,-1,19,12,42,13,13
"624",154,255,21,31,1,3,3,10,7,19,9,1,2,2
"625",154,221,22,21,1,44,3,6,6,19,8,1,2,2
"626",155,99,1,-15.25,1,4,1,10,3,28,4,1,1,1
"627",155,69,2,28.57143,1,7,1,10,5,28,3,1,2,-2
"628",155,194,3,23.5,1,2,3,10,6,28,7,1,1,1
"629",155,1,4,71,1,6,1,10,12,28,1,1,11,-11
"630",155,250,5,31,0,5,5,1,11,28,9,3,2,-2
"631",155,322,6,31,0,3,3,4,7,28,11,1,4,4
"632",155,264,7,11.428572,1,20,1,10,9,28,9,1,0,0
"633",155,6,8,31,1,7,1,10,0,28,1,1,1,1
"634",155,356,9,17.714285,1,2,1,10,12,28,12,3,0,0
"635",155,22,10,21,1,21,1,10,1,28,1,1,0,0
"636",155,141,11,41,1,4,1,9,5,28,5,16,0,0
"637",155,202,12,41,1,4,5,9,6,28,7,1,1,1
"638",155,324,13,15.571428,1,10,3,7,11,28,11,1,0,0
"639",155,317,14,16.428572,1,4,3,10,11,28,11,1,0,0
"640",155,334,15,3.8571434,0,4,5,4,11,28,12,3,1,1
"641",155,73,16,30.857143,0,2,3,9,3,28,3,3,0,0
"642",155,104,17,21,1,3,3,9,2,28,4,1,2,2
"643",155,84,18,40.42857,1,5,5,6,5,28,3,1,2,-2
"644",155,203,19,21,1,7,5,7,2,28,7,1,5,5
"645",155,132,20,1,1,2,3,4,3,28,5,1,2,2
"646",155,220,21,61,0,3,5,3,7,28,8,3,1,1
"647",155,355,22,11,1,5,5,3,11,28,12,1,1,1
"648",155,291,23,24.285715,0,12,5,1,9,28,10,3,1,1
"649",155,265,24,41,0,6,4,2,10,28,9,1,1,-1
"650",155,172,25,51,1,6,1,10,6,28,6,18,0,0
"651",155,226,26,26,0,2,4,4,5,28,8,1,3,3
"652",155,164,27,31,0,2,5,5,8,28,6,1,2,-2
"653",155,293,28,51,0,7,2,3,9,28,10,1,1,1
"830",156,18,1,28.857143,1,27,1,10,1,18,1,12,0,0
"831",156,270,2,21,0,11,5,1,-1,18,10,3,11,11
"832",156,17,3,8.5,1,19,1,10,1,18,1,1,0,0
"833",156,338,4,11,1,10,3,7,8,18,12,14,4,4
"834",156,141,5,65.57143,1,5,3,7,6,18,5,1,1,-1
"835",156,45,6,1,1,9,1,10,2,18,2,1,0,0
"836",156,141,7,43.142857,1,4,1,10,6,18,5,12,1,-1
"837",156,144,8,31,1,50,1,9,4,18,5,1,1,1
"838",156,161,9,22.571428,0,6,1,9,4,18,6,1,2,2
"839",156,8,10,37.285713,1,4,1,10,0,18,1,1,1,1
"840",156,46,11,21,1,11,1,10,1,18,2,1,1,1
"841",156,352,12,21,1,4,3,8,11,18,12,14,1,1
"842",156,180,13,30.857143,1,15,1,10,7,18,7,1,0,0
"843",156,197,14,11.1428585,1,8,1,10,4,18,7,15,3,3
"844",156,72,15,1,1,4,1,10,2,18,3,1,1,1
"845",156,280,16,21,1,7,3,10,9,18,10,14,1,1
"846",156,162,17,11,1,21,1,10,6,18,6,3,0,0
"847",156,107,18,6,1,4,3,10,5,18,4,12,1,-1
"654",158,75,1,2.4285717,1,7,1,10,2,10,3,1,1,1
"655",158,14,2,1,1,8,1,10,0,10,1,1,1,1
"656",158,19,3,21,1,19,1,7,1,10,1,1,0,0
"657",158,202,4,31,1,3,4,5,8,10,7,1,1,-1
"658",158,85,5,37.285713,1,14,1,9,3,10,3,3,0,0
"659",158,258,6,-5.25,0,2,5,3,-1,10,9,1,10,10
"660",158,254,7,21,0,3,3,5,8,10,9,27,1,1
"661",158,205,8,31,0,2,4,3,7,10,7,1,0,0
"662",158,196,9,21,0,4,4,4,6,10,7,3,1,1
"663",158,12,10,1,1,17,3,5,0,10,1,1,1,1
"664",159,66,1,-4,1,2,1,10,2,26,3,1,1,1
"665",159,36,2,41,1,3,1,10,1,26,2,1,1,1
"666",159,14,3,51,1,32,1,10,0,26,1,3,1,1
"667",159,37,4,48.857143,1,4,1,10,1,26,2,4,1,1
"668",159,66,5,11,1,3,1,10,2,26,3,1,1,1
"669",159,134,6,-19.57143,1,8,1,10,4,26,5,1,1,1
"670",159,336,7,41,1,2,1,7,11,26,12,1,1,1
"671",159,283,8,20.285715,0,4,5,6,10,26,10,1,0,0
"672",159,97,9,39.857143,0,2,4,10,3,26,4,1,1,1
"673",159,2,10,45.285713,1,3,2,10,0,26,1,35,1,1
"674",159,166,11,45.857143,1,8,1,10,6,26,6,44,0,0
"675",159,184,12,37,1,9,1,7,6,26,7,48,1,1
"676",159,252,13,32,1,3,1,7,8,26,9,14,1,1
"677",159,272,14,25.571428,0,2,3,4,9,26,10,1,1,1
"678",159,323,15,5.4285717,1,2,1,9,11,26,11,3,0,0
"679",159,107,16,51,1,3,1,10,3,26,4,5,1,1
"680",159,37,17,21,1,4,5,10,1,26,2,1,1,1
"681",159,14,18,49.714287,1,5,1,10,0,26,1,1,1,1
"682",159,165,19,58,1,6,1,10,5,26,6,13,1,1
"683",159,235,20,21,1,3,5,6,4,26,8,14,4,4
"684",159,217,21,41,1,6,1,10,10,26,8,14,2,-2
"685",159,348,22,60.57143,1,2,1,10,12,26,12,1,0,0
"686",159,99,23,51,1,3,4,7,4,26,4,2,0,0
"687",159,222,24,51,1,2,2,6,5,26,8,20,3,3
"688",159,268,25,12.25,1,7,5,9,9,26,9,1,0,0
"689",159,278,26,2.1428566,0,2,1,3,12,26,10,1,2,-2
"690",160,129,1,38.57143,1,7,1,10,4,15,5,14,1,1
"691",160,280,2,34.714287,1,2,1,10,9,15,10,12,1,1
"692",160,35,3,-4.000001,1,16,1,10,1,15,2,1,1,1
"693",160,190,4,18.571428,1,11,1,10,3,15,7,7,4,4
"694",160,25,5,31,1,51,1,10,0,15,1,1,1,1
"695",160,109,6,15.285715,1,4,1,10,6,15,4,12,2,-2
"696",160,11,7,41,1,85,1,10,0,15,1,1,1,1
"697",160,108,8,21,0,6,4,10,3,15,4,1,1,1
"698",160,261,9,41,1,8,1,10,8,15,9,1,1,1
"699",160,146,10,-1.5,0,3,3,10,4,15,5,12,1,1
"700",160,121,11,25.571428,1,4,1,10,4,15,5,14,1,1
"701",160,290,12,11,1,9,1,10,9,15,10,12,1,1
"702",160,6,13,21,1,83,1,10,0,15,1,1,1,1
"703",160,219,14,13.142858,1,2,1,10,5,15,8,1,3,3
"704",160,170,15,62.571426,0,5,4,10,5,15,6,1,1,1
"705",160,226,16,41,0,12,5,1,-1,15,8,14,9,9
"706",160,80,17,11,0,2,4,10,5,15,3,1,2,-2
"707",160,245,18,45.714287,0,3,4,10,8,15,9,12,1,1
"708",161,60,1,41,1,6,1,10,1,24,3,12,2,2
"709",161,241,2,9.75,1,2,1,4,3,24,9,1,6,6
"710",161,107,3,7.8571424,1,9,1,6,2,24,4,1,2,2
"711",161,205,4,31,1,11,1,5,6,24,7,1,1,1
"712",161,341,5,7.428571,1,2,1,5,12,24,12,14,0,0
"713",161,346,6,11,1,2,1,4,11,24,12,1,1,1
"714",161,88,7,7,1,8,1,10,3,24,3,1,0,0
"715",161,79,8,58.857143,1,20,1,10,2,24,3,14,1,1
"716",161,206,9,54.285713,1,2,4,6,6,24,7,3,1,1
"717",161,133,10,43.428574,1,7,1,7,4,24,5,1,1,1
"718",161,129,11,28.857143,1,2,1,5,6,24,5,1,1,-1
"719",161,3,12,41,1,3,4,10,0,24,1,1,1,1
"720",161,302,13,-15.25,0,4,5,1,-1,24,11,1,12,12
"721",161,210,14,48.5,1,3,5,5,7,24,8,12,1,1
"722",161,187,15,36.714287,1,16,4,10,6,24,7,23,1,1
"723",161,168,16,11,1,7,1,6,5,24,6,1,1,1
"724",161,13,17,31,1,16,1,10,0,24,1,3,1,1
"725",161,11,18,26.714287,1,21,1,10,0,24,1,1,1,1
"726",161,58,19,11,1,23,1,10,1,24,1,3,0,0
"727",161,353,20,48.714287,1,16,1,10,12,24,12,1,0,0
"728",161,160,21,43,1,5,2,7,3,24,6,3,3,3
"729",161,52,22,74,1,4,5,10,2,24,2,3,0,0
"730",161,89,23,33.5,0,3,5,1,-1,24,3,1,4,4
"731",161,101,24,25.571428,0,15,5,1,-1,24,4,1,5,5
"732",162,116,1,-16.5,0,2,5,5,-1,16,4,1,5,5
"733",162,326,2,21,0,4,5,1,12,16,11,3,1,-1
"734",162,40,3,41,1,6,1,10,4,16,2,3,2,-2
"735",162,292,4,1,1,4,5,1,6,16,10,1,4,4
"736",162,45,5,41,1,2,5,5,4,16,2,25,2,-2
"737",162,282,6,17.285713,1,3,5,4,9,16,10,1,1,1
"738",162,234,7,34.857143,0,3,5,1,7,16,8,12,1,1
"739",162,278,8,21,1,3,3,5,9,16,10,1,1,1
"740",162,86,9,0.14285713,1,5,5,5,6,16,3,1,3,-3
"741",162,317,10,40.857143,0,8,5,1,-1,16,11,5,12,12
"742",162,3,11,25.857143,1,2,1,5,0,16,1,23,1,1
"743",162,358,12,31,1,2,3,5,12,16,12,1,0,0
"744",162,29,13,105,1,132,1,10,0,16,1,1,1,1
"745",162,59,14,41,1,4,5,5,4,16,2,1,2,-2
"746",162,215,15,16.714287,1,11,3,5,8,16,8,1,0,0
"747",162,8,16,54.142857,1,185,1,10,0,16,1,1,1,1
"748",162,329,17,20.285715,1,4,3,5,11,16,11,5,0,0
"749",162,349,18,51,1,8,1,10,11,16,12,1,1,1
"750",167,0,1,37.142857,1,4,1,10,0,19,1,1,1,1
"751",167,108,2,9.571428,1,6,1,10,7,19,4,1,3,-3
"752",167,3,3,11,1,7,1,10,0,19,1,1,1,1
"753",167,152,4,21,1,5,1,10,5,19,6,1,1,1
"754",167,223,5,20.142857,1,3,1,8,4,19,8,1,4,4
"755",167,113,6,31,1,4,1,10,3,19,4,3,1,1
"756",167,196,7,42.142857,1,4,1,7,6,19,7,23,1,1
"757",167,44,8,-4.5714283,1,17,1,10,2,19,2,1,0,0
"758",167,142,9,12.857143,1,3,1,10,9,19,5,25,4,-4
"759",167,357,10,1,0,2,1,1,-1,19,12,12,13,13
"760",167,99,11,8.428572,1,4,1,8,4,19,4,1,0,0
"761",167,235,12,30.285715,1,4,1,10,7,19,8,12,1,1
"762",167,130,13,41,1,4,2,10,4,19,5,1,1,1
"763",167,335,14,21,0,2,2,2,11,19,12,1,1,1
"764",167,31,15,41,1,4,1,10,1,19,2,1,1,1
"765",167,323,16,21,1,4,2,5,10,19,11,1,1,1
"766",167,330,17,41,1,7,3,5,11,19,12,11,1,1
"767",167,242,18,31,1,3,2,7,8,19,9,1,1,1
"768",167,0,19,51,1,5,2,10,0,19,1,1,1,1
"769",173,6,1,30.285715,1,7,1,10,0,18,1,1,1,1
"770",173,33,2,1,1,5,1,10,1,18,2,1,1,1
"771",173,139,3,21,1,6,2,10,8,18,5,3,3,-3
"772",173,90,4,11,1,2,1,10,3,18,4,5,1,1
"773",173,98,5,35.571426,1,3,1,10,6,18,4,2,2,-2
"774",173,69,6,18.285713,1,23,1,10,3,18,3,12,0,0
"775",173,354,7,9.428572,1,6,1,10,12,18,12,1,0,0
"776",173,294,8,1,1,3,1,10,8,18,10,1,2,2
"777",173,27,9,30.142857,1,3,4,10,1,18,1,12,0,0
"778",173,80,10,11,1,41,3,7,3,18,3,1,0,0
"779",173,50,11,1,1,42,1,10,1,18,2,3,1,1
"780",173,16,12,27.142857,1,20,1,10,0,18,1,3,1,1
"781",173,352,13,19.285715,0,3,5,2,-1,18,12,12,13,13
"782",173,84,14,31,1,41,1,10,3,18,3,3,0,0
"783",173,356,15,31,0,4,3,10,11,18,12,1,1,1
"784",173,100,16,1,0,2,1,3,-1,18,4,1,5,5
"785",173,190,17,11.714286,1,4,1,10,5,18,6,27,1,1
"786",173,45,18,17.285713,0,2,3,2,-1,18,2,14,3,3
"787",174,61,1,24,1,2,1,10,3,24,3,1,0,0
"788",174,77,2,21,1,17,1,10,3,24,3,1,0,0
"789",174,268,3,41,1,10,1,7,7,24,9,12,2,2
"790",174,16,4,31,1,36,1,10,0,24,1,1,1,1
"791",174,168,5,31.714287,0,6,5,1,-1,24,6,1,7,7
"792",174,289,6,18.428572,1,6,1,7,10,24,10,1,0,0
"793",174,58,7,21,1,6,5,5,2,24,2,1,0,0
"794",174,90,8,31,1,18,2,8,1,24,4,3,3,3
"795",174,197,9,15.857143,1,12,1,10,-1,24,7,5,8,8
"796",174,170,10,47.857143,1,9,1,9,5,24,6,1,1,1
"797",174,29,11,11,1,4,1,10,1,24,1,1,0,0
"798",174,204,12,26.714285,1,7,1,8,4,24,7,14,3,3
"799",174,45,13,3.7142859,1,5,2,5,1,24,2,1,1,1
"800",174,176,14,16.714287,0,4,5,1,0,24,6,16,6,6
"801",174,147,15,9.75,1,9,4,8,-1,24,5,12,6,6
"802",174,71,16,14.142857,1,3,1,7,2,24,3,53,1,1
"803",174,328,17,11,0,13,1,1,-1,24,11,1,12,12
"804",174,307,18,21,1,3,1,9,10,24,11,1,1,1
"805",174,333,19,21,1,3,4,9,11,24,12,1,1,1
"806",174,260,20,29.285715,0,9,4,3,8,24,9,1,1,1
"807",174,267,21,38.5,0,3,2,1,-1,24,9,1,10,10
"808",174,45,22,21,0,3,1,1,-1,24,1,1,2,2
"809",174,93,23,11,1,3,4,6,1,24,4,1,3,3
"810",174,21,24,11,1,13,1,9,1,24,1,1,0,0
"811",175,44,1,11,1,4,1,10,1,19,2,1,1,1
"812",175,254,2,33.571426,0,3,4,10,7,19,9,1,2,2
"813",175,65,3,20.142857,1,2,1,10,3,19,3,1,0,0
"814",175,32,4,11,1,11,1,10,0,19,2,14,2,2
"815",175,44,5,9.571428,1,5,1,10,1,19,2,14,1,1
"816",175,263,6,12.857143,0,2,4,10,4,19,9,14,5,5
"817",175,2,7,31,1,11,1,10,0,19,1,16,1,1
"818",175,170,8,31,1,4,1,10,5,19,6,23,1,1
"819",175,133,9,41,1,2,1,10,11,19,5,27,6,-6
"820",175,110,10,48.42857,1,2,1,10,3,19,4,12,1,1
"821",175,300,11,21,1,5,1,10,12,19,11,1,1,-1
"822",175,165,12,51,1,8,1,10,6,19,6,3,0,0
"823",175,81,13,31,1,7,1,10,2,19,3,3,1,1
"824",175,215,14,31,0,2,5,1,-1,19,8,1,9,9
"825",175,15,15,46.714287,1,2,1,10,1,19,1,14,0,0
"826",175,306,16,41,0,2,5,1,-1,19,11,16,12,12
"827",175,231,17,31,1,3,1,10,7,19,8,1,1,1
"828",175,9,18,31,1,4,5,5,1,19,1,1,0,0
"829",175,310,19,13.5,1,15,1,10,1,19,11,1,10,10
